11111111111111111
1P00000000X1C00X1
11101110111110111
1C0000000000000X1
1X000000000000001
10101011X1C110101
1X0000000000000E1
11111111111111111
